5 8 2
EEEEOOOO
OEOEEEEE
OEEEOEOE
OOEOGEOE
EEEEOEEE