5 8 2
EEEEOOOO
OEOEEEEG
OEEEOEOE
OOEOGEOE
EEEEOEEE