VVEEOOOO
OVOVVVEG
OVVVOVOV
OOVOGVOV
VVVVOVVV
