VVVVOOOO
OVOVVVVV
OVVVOVOV
OOVOGVOV
VVVVOVVV
