23 30
EEEOOEEEEEOEEEEEOOEOEEE
EEOOEOOEOEEEOEOEEEEEEOE
OEOEEEEEOEOEEEEEOEOOOEE
EEOEOEOEEEOEEOEOEEEEEEO
OEEEOEOOEEOEEEEOEOEOEOO
OEOEOEEEEEOEEOEEEOEOEOE
EEEOOOEOEEOEEOEOEEEEEEE
EOEOEEOEEEEOEEEEOEOEOOE
EEEOEEEOEEOEOEOEEEEEEEE
EOEOEEOEEEOEEEEEOEOEOOE
EOEOEEEEOEEEEOEOEEEEEEE
EOEOEEOEEEOEEOEEEOEOEOE
EEEEEEOEEEOEEEEOEOEOEOO
OEOEEOEEOEOEEOEOEEEEEEO
EEEEEEEEEEOEEEEEOEOOOEE
OEOEEOEEOEEEOEOEEEEEEOE
EEOEOEOEEEOEEEEEOOEOEEE
EEEOOEEEEEEEOEOEEEEEEEE
EEOOEOOEOEEEOEOEEEEEEOE
OEEEOEOOEEOEEEEEOOEOEEE
EEEOOEEEEEOEEEEEOOEOEEE
EEOOEOOEOEEEOEOEEEEEEOE
OEOEEEEEOEOEEEEEOEOOOEE
EEOEOEOEEEOEEOEOEEEEEEO
OEEEOEOOEEOGEEEOEOEOEOO
EEEOOEEEEEOEEEEEOOEOEEE
EEOOEOOEOEEEOEOEEEEEEOE
OEOEEEEEOEOEEEEEOEOOOEE
EEOEOEOEEEOEEOEOEEEEEEO
OEEEOEOOEEOEEEEOEOEOEOO