9 9
OOOOOOOOO
OEOEEEEEO
OEOOEOOEO
OEOEEOEEO
OEOEOEOEO
OEEEEEOEO
OEEEEEEGO
OOOOOOOOO

