12 20
EEEOOEEEEEOE
EEOOEOOEOEEE
OEOEEEEEOEOE
EEOEOEOEEEOE
OEEEOEOOEEOE
OEOEOEEEEEOE
EEEOOOEOEEOE
EOEOEEOEEEEO
EEEOGEEOEEOE
EOEOEEOEEEOE
EOEOEEEEOEEE
EOEOEEOEEEOE
EEEEEEOEEEOE
OEOEEOEEOEOE
EEEEEEEEEEOE
OEOEEOEEOEEE
EEOEOEOEEEOE
EEEOOEEEEEEE
EEOOEOOEOEEE
OEEEOEOOEEOE